000000000000000000000000000000000000000000000000000
000000000000000000000000000000000000000000000000000
000000000000000000000000000000000000000000000000000
111111000000000000000000000000000000000000000000000
000001000000000000000000000000000000000000000000000
000001000000000000000000000000000000000000000000000
000001000000000000000000000000000000000000000000000
000001000000000000000000000000000000000000000000000
000001000011111111111111111111111111111111000000000
000001000010000000000000000000000000000001000000000
000001000010000000000000000000000000000001000000000
000001000010000000000000000000000000000001000000000
000001111110000000000000000000000000000001000000000
000000000000000000000000000000000000000001000000000
000000000000000000000000000000000000000001000000000
000000000000000000000000000000000000000001000000000
000000000000000000000000000000000000000001000000000
000000000000000000000000000000000000000001000000000
000000000000000000000000000000000000000001000000000
000000000000000000000000000000000000000001000000000
000000000000000000000000000000000000000001000000000
000000000000000000000000000000000000000001000000000
000000000000000000000000000000000000000001000000000
000000000000000000000000000000000000000001000000000
000000000000000000000000000000000000000001000000000
0000000000000000000000000X0000000000000001000000000
000000000000000000000000010000000000000001000000000
000000000000111110000000010000000000000001000000000
000000000000100010000000010000000000000001000000000
000000000000100010000000010000000000000001000000000
000000000000100011111111110000000000000001000000000
000000000000100000000000000000000000000001000000000
000000000000100000000000000000000000000001000000000
000000000000111111111111110000000000000001000000000
000000000000000000000000010000000000000001000000000
000000000000000000000000010000000000000001000000000
000000000000000000000000010000000000000001000000000
000000000000000000000000010000000000000001000000000
000000000000000000000000010000000000000001000000000
000000000000000000000000010000000000000001000000000
000000000000000000000000011111111111111111000000000
000000000000000000000000000000000000000000000000000
000000000000000000000000000000000000000000000000000
000000000000000000000000000000000000000000000000000
000000000000000000000000000000000000000000000000000
000000000000000000000000000000000000000000000000000
000000000000000000000000000000000000000000000000000
000000000000000000000000000000000000000000000000000
000000000000000000000000000000000000000000000000000
000000000000000000000000000000000000000000000000000
000000000000000000000000000000000000000000000000000