000000000000000000000000000000000000000000000000000
000000000000000000000000000000000000000000000000000
000000000000000000000000000000000000000000000000000
000000000000000000000000000000000000000000000000000
111111111111111111111111111111111111111111111110000
000000000000000000000000000000000000000000000010000
000000000000000000000000000000000000000000000010000
000000001111111111111111111111111111111111111110000
000000001000000000000000000000000000000000000000000
000000001000000000000000000000000000000000000000000
000000001111111111111111111111111111111111111110000
000000000000000000000000000000000000000000000010000
000000000000000000000000000000000000000000000010000
000000001111111111111111111111111111111111111110000
000000001000000000000000000000000000000000000000000
000000001000000000000000000000000000000000000000000
000000001000000000000000000000000000000000000000000
000000001000000000000000000000000000000000000000000
000000001000000000000000000000000000000000000000000
000000001000000000000000000000000000000000000000000
000000001000000000000000000000000000000000000000000
000000001000000000000000000000000000000000000000000
000000001000000000000000000000000000000000000000000
000000001000000000000000000000000000000000000000000
000000001000000000000000000000000000000000000000000
0000000011111111111111111X0000000000000000000000000
000000000000000000000000000000000000000000000000000
000000000000000000000000000000000000000000000000000
000000000000000000000000000000000000000000000000000
000000000000000000000000000000000000000000000000000
000000000000000000000000000000000000000000000000000
000000000000000000000000000000000000000000000000000
000000000000000000000000000000000000000000000000000
000000000000000000000000000000000000000000000000000
000000000000000000000000000000000000000000000000000
000000000000000000000000000000000000000000000000000
000000000000000000000000000000000000000000000000000
000000000000000000000000000000000000000000000000000
000000000000000000000000000000000000000000000000000
000000000000000000000000000000000000000000000000000
000000000000000000000000000000000000000000000000000
000000000000000000000000000000000000000000000000000
000000000000000000000000000000000000000000000000000
000000000000000000000000000000000000000000000000000
000000000000000000000000000000000000000000000000000
000000000000000000000000000000000000000000000000000
000000000000000000000000000000000000000000000000000
000000000000000000000000000000000000000000000000000
000000000000000000000000000000000000000000000000000
000000000000000000000000000000000000000000000000000
000000000000000000000000000000000000000000000000000